Aleph - A
Aleph Dagesh \
Beth - B
Beth Dagesh - ]
Gimel - C
Gimel Dagesh - ^
Daleth - D
Daleth Dagesh - _
He - E
He Dagesh - `
Vav - F
Cholem Vav - }
Shureq Vav - a
Zayin - G
Zayin Dagesh - b
Cheth - H
Teth - I
Teth Dagesh - d
Yod - J
Yod Dagesh - e
Kaph - L
Kaph Dagesh - g
Kaph Sofit - K
Kaph Sofit Qamets - |
Lamed - M
Lamed Dagesh - h
Mem - O
Mem Dagesh - j
Mem Sofit - N
Nun - Q
Nun Dagesh - l
Nun Sofit - P
Samek - R
Samek Dagesh - m
Ayin - S
Pe - U
Pe Dagesh - p
Pe Sofit - T
Pe Sofit Dagesh - o
Tsade - W
Tsade Dagesh - r
Tsade Sofit - V
Quph - X
Quph Dagesh - s
Resh - Y
Resh Dagesh - t
Sin - y
Sin Dagesh -z
Sin/Shin - Z
Shin - w
Shin Dagesh - x
Tav - [
Tav Dagesh - v

Left Curly Brace - "\x8B"   For Alternate Readings
Right Curly Brace - "\x8C"  For Alternate Readings
Vertical Bar - "\x91"       For Alternate Readings

Qamets  - "\xA0"
Pathach - "\xA1"
Tsere   - "\xA2"
Segol   - "\xA3"
Chireq  - "\xA4"
Shewa   - "\xA5"
Qibbuts - "\xA6"
Cholem  - "\xA7"
Chateph Qamets - "\xA8"
Chateph Pathach - "\xA9"
Chateph Segol - "\xAA"
Pathach Chireq - "\xAB"
Qamets Chireq - "\xAC"
Pathach Shewa - "\xAD"
Qamets Shewa - "\xAE"


